acer=aser,асег,aser,асера,айсер,acep
alcatel=alkatel,алкатель,алкатело,алькатель
explay=expley,explai
htc=hts,нтс
desire=дизаера,disaer,decire,disire
iphone=айфончик,айфон,iphon,ipone,аифон,aphone,iphone,ipfone,lphone,ipone,айф,ihone,iphine,айфош
apple=aple,appel,aplle,эпплый,эпл,аррl,эйплый
ipad=айпад,aipad,айпэда,ipab,lpad
ipod=айпод
android=андроид,андройда,andriod,андра,androidtm,системаandroid,ocandroid,андроить,андройд,анроид
mac=мас,мак
macbook=makbook,макбук
air=эйер,эйр,айр,эир,аир,эйер,
lenovo=lenova,леново,ienovo,леновый,
mts=mtc,мтс
megafon=мегафон,мегофон,мгф
tele2=теле2
beeline=билайн
yota=йот,
nokia=нокиа,нокия,нокио
lumia=люмиа,люмия,лумия
philips=филипс,fhilips,phillips,filips
panasonic=панасоник,panasonik
siemens=сименс,simens,simients
sony=soni,sonu,соня,
lg=лджи
samsung=sumsung,самсунг,samsyng,samsun,samung,слмсунг,самунг
galaxy=гелаксить,галаксить,гелекси,гэлэксить,гэлаксить,галоксить,gelaxy,galaxi,calaxy,galaxsy,galaksi,galaxsi,гелекси,galxy,gаlах,galaxu,calaxy
huawei=huawey
hp=нp

ram=озу,ozu,vram,оператив,оперативка,ozy

ford=форд
focus=fokus,фокус,
transit=tranzit,транзит
sorento=соренто
impreza=импреза
camry=камри
sportage=спортейдж,спортадж
ducato=dukato,дукато
octavia=октавиа,актавий,октавий
colt=кольт
scenic=сценик
corolla=королл,carolla
matrix=martix
asx=асх
clio=клио
cherokee=чероки
discovery=дискавери
matiz=матиза
legacy=легасить,legasy


jumper=jamper,jumpy,джампер,джампить,
accord=акорд,acord
avensis=авенсис
freelander=фрилендер,фриландер,фрилэндэр
qashqai=кашкай,qashkai
cerato=ceratto,серато
outlander=outlender,аутлендер,оутландер,оутлэндер,оутлендер,оутландер,оутлэндер,аутлендер,оутлендер
teana=теана
nexia=нексия,нексиа,нексиа,нексия,nexsia
caddy=кадди
sandero=сандеро
hunter=hanter
fusion=фюжина,фьюжн
solaris=солярис
cayenne=кайена,cayene,кайный,кайенна,каенна,каена,каен
газель=газеле,газелька
kuga=куга
cooper=coper,
pajero=паджеро,pagero,padjero,
civic=цивика,civik
fabia=фабия,фабиа,
korando=корандо
musso=муссо
symbol=simbol,симбол,симвал
ghost=gost
daily=дейли,дэйль
fluence=флюинс,флюэнс,флюенц

saab=сааб
iveco=iveko,ивеко

skoda=scoda,скод,шкода,shkoda
faw=фав
lexus=лексус,лексуса
камаз=kamaz
opel=опель,
audi=ауди
chevrolet=shevrolet,chev,chevrole
porsche=porshe,порше,порша,порш,porche
lifan=лифан,
datsun=датсун
smart=смарт,smar,smat
suzuki=сузук
volkswagen=vw,volksvagen,wv,wolkswagen,wolksvagen,фольскваген,фолцваген,фольцваген,фольскваген,фолксваген,фольцфаген,фолькс,фольцваген,фольцфаген,фолксваген,фольц,фолькс,фольсваген,вольксваген,фолькцваген,фольтсваген,фолькс,фольксваген,фолскваген,фолец
dodge=додж,додже
isuzu=исуза,исудз
cadillac=кадиллак,кадилак
honda=xonda,хонда,ходно
toyota=tayota,toyta,тойота,
hummer=хаммера,хамер
hyundai=hyndai,hyunday,huyndai,hundai,hyindai,hunday,hendai,дляhyundai,henday,hyunda,hynday,huinday,huandai,хендать,hyudai,хундать,хюндать,хэндать,хендэ,хондать,хьюндать,hyndai
mazda=мазд
infiniti=инфинить,infinity
bmw=бмв,bmv
kia=kio,киа
mitsubishi=mitsubichi,mitsu,mitsubisi,mitsubish,mitsubushi,митсубисать,мицубись,митсубись,mitsubihi,mitsibishi,митсубись,митцубись,мицубись,митсубисать,mitsubish,
peugeot=пежо
daewoo=daewo,dewoo,deawoo,dey,део,дэу,эсперо,дэо,деу,даево,dey,
fiat=фиат
jaguar=ягуар
renault=renalt,рено,reno,renaut
nissan=ниссан,нисан
dongfeng=донгфенг,фенг,feng,донфенг,dong
volvo=вольво,волвый,волев
chrysler=крайслера
citroen=ситройня,ситроить,ситроен,citron
ssangyong=сангенг,ссанга,саньенг,сангйонг,ссангйонг,санга,
range=rang,рэндж,рандж,рендж,ренж,рендж,рейндж,рэнж,рандж,рейнж,renge
rover=rove,ровер,rower
voyager=вояджер,вояжёр
cherokee=чероки
estina=истим,эстина
jawa=ява
getz=gets,гетс,гец,гетз

уаз=уазик,uaz
lada=лада
kalina=калина
niva=нива
москвич=москвичь,
иж=ижа,ижак
самосвал=сомосвал,самасвал

nike=найкть,найк,naik,
adidas=адидас,addidas,аддидас
puma=пума,
reebok=рибок,rebook
demix=демикс
кроссовок=кросовка,красавка,кроссика,кроса,кросовочек,красовка,кроссовочек,крассовка

